1111111111111111111111111111111
1P00000001MMM000000000000100001
100000000000M00000000000000E001
10000000010MM000000000000111111
10000000010M0000000000000000001
1000000001000000000010000000001
1111100001000000000011111010001
1000000001000000000010C00010001
1000000001000000000011111110001
1000001111000000000010000000001
1000000001000000000010000000001
1000000001000MMMMM0010000000001
1000000001110000000010000000001
10000C0000010000000000000000001
1000000001110000000000000000001
1000000001000000111100000000001
11111111010000001C0000000000001
1C00010001000000111100000000001
1000010001000000000000000000001
1000010001000000000000000000001
1000000C0000000C000000000000001
1111111111111111111111111111111