1111111111111111111111111111111
1000000001000000000000000100001
100000000100000000000000000E001
10000000P0000000C00000000111111
1000000001000000000000000000001
1000000001000000000000000000001
1000000C0000000C000000000000001
1111111111111111111111111111111