1111111111111111111111111111111111
1E0000000000000C00000C00000P0000P1
1111111111111111111111111111111111
