1111111111111111111111111111111111
10P00000000011000000000000000000E1
1011111011111011111110111111101111
1000000000000000000000000000100001
1111011010111011111011111010111011
1111111111111011111111111111111111
1111111111111011111110111111101111
1000000000001010000000000000100001
1011101111101010111111111110111011
1C00001000000000100000000000000C01
1011101011111010111011111110111111
1000100000000000000000000000000011
1111111111111111111111111111111111