11111
10001
100P1
10001
1C001
10001
10001
10001
11101
10001
10001
10001
10001
10001
10001
10001
10001
10001
10001
10001
10001
100E1
11111