1111111111111111111111111111111
10000000010000000C0M00000100001
100P00000000000000000000000E001
1000000001000000000000000111111
1000000001000000000000000000001
100000000100000000000000M000001
1111100001000000000011111010001
1111100001111100000010C00010001
1100000011110000000010111110001
1000001111100000011110100000001
1000000001110000000000100000001
1000000001101100000001110000001
1000000001111111000010000000001
11000C0000000011000000000000001
1100000001111110000000000000001
1100000001111100111111110000001
11111111011111011C0000000M00001
1C11111001110001111000000C00001
1001111001110000000000000000001
1001111001110000000001111111111
1000000C0000000C000001111111111
1111111111111111111111111111111