1111111111111111111111111111111
1P000000010000000C0M00000100001
100000000000000000000000000E001
1000000001000000000000000111111
1000000001000000000000000000001
100000000100000000000000M000001
1111100001000000000011111010001
1000000001100000000010C00010001
1000000001000000000011111110001
1000001111000000000010000000001
1000000001000000000010000000001
1000000001000000000010000000001
1000000001111111000010000000001
10000C0000000001000000000000001
1000000001111111000000000000001
1000000001000000111100000000001
11111111010000001C0000000M00001
1C00010001000000111100000C00001
1000010001000000000000000000001
1000010001110000000000000000001
1000000C0000000C000000000000001
1111111111111111111111111111111