11111111111111111111111111111111111111111111111111111111111111
1P0000000100000000000000010000111111000010000000000111011100E1
10000000010000000000000000000011111100001000000000011101110001
10000000010000000000000001111111111100001000000000011101110001
10000000010000000000000000000011111100001000000000011101110001
10000000010000000000100000000011000000001000000111100000000001
11111000010000000000111011100011000000001000000111100000000001
1000000001000000000010C000100011000000001000000111100000000001
10000000010000MM0000111111100011000000001000000111100000000001
10000011110000000000100000000011000000001000000111100000000001
10000000010000000000100000000011000000001000000111100000000001
10000000010000000000100000000011000000001000000111100000000001
10000000011100000000100000000011000000001000000111100000000001
10000C00000100000000000000000011000000001000000111100000000001
10000000011100000000000000000011000000001000000111100000000001
100000000100000011110000MMMMMMMMMMMMMMMM0000000000000000000001
11111111010000001C00000000000011000000001000000111100000000001
1C0000000100000011110000000M0011000000001000000111100000000001
10000111110000000000000000000011000000001000000111100000000001
10000100010000000000000000000011000000001000000111100000000001
1000010C0110000C0000000000000011000000001000000111100000000001
10000111000000000000000001000011000000001000000111100000000001
10111111011111111111111111110111000000001000000111100000000001
10000000010000000000000001110111000000001000000111100000000001
10000000010000000000000000000011000000001000000111100000000001
10000000010000000000100000000011000000001000000111100000000001
11111000010000000000111111100011000000001000000111100000000001
1000000001000000000010C000000011000000001000000111100000000001
10000000010000000000111111100011000000001000000111100000000001
10000011110000000000100000000011000000001000000111100000000001
10000010010000000000000001000011000000001000000111100000000001
11111111111111111111111111111111111111111111111111111111111111