1111111111111111111111111111111
100000000C000000000000M001000E1
10000P0001000000000000000000001
1111111111111111111111111111110
