1111111111111111111111111111111
100000000000000000C000000100001
10000P000100000000000000000E001
1111111111111111111111111111111
