1111111111111111111111111111111
1000000000001100000000000100000
10000P0001000000000000000000001
1111111111111111111111111111111
