1111111111111111111111111111111
10000000010CCCCCCCCCCCC001000E1
10000P0001000000000000000000001
1111111111111111111111111111111
