1111111111111111111111111111111111
100000000000000C00000C00000P0000E1
1111111111111111111111111111111111
